66666666666
*63612161211
*62616111666
*61666266616
*61216112126
*66616261666
*61211161166
*61666666666
*66666666666